[Example]
start_pos: z=0, x=1, y=1
map:
 WWWWWW
 W W  W
 W W  W
 W W  W
 W >  W
 W    W
 W    W
 WWWWWW

 WWWWWW
 W +  W
 W +  W
 W +  W
 W <  W
 W    W
 W    W
 WWWWWW

[Example2]
start_pos: z=0, x=1, y=1
map:
 WWWWWW
 W W  W
 W W  W
 W W  W
 W >  W
 W    W
 W W  W
 WWWWWW

 WWWWWW
 W +  W
 W +  W
 W +  W
 W <  W
 W    W
 W    W
 WWWWWW