[Large Maze]
start_pos: z=0, x=1, y=1
map:
 WWWWWWWWWWWWWW
 W.W..W.......W
 W.W..WWWWW..WW
 W.W..W...WW..W
 W.>....W>W...W
 W......W...W.W
 W......W...W.W
 WWWWWWWWWWWWWW
 , W
 , W
 , W
 , WW

 WWWWWWWWWWWWWW
 W .  W       W
 W .  W  .W   W
 W .  W  ...  W
 W <  W  <W   W
 W    W  WWW  W
 W    W   W   W
 WWWWWWWWWWWWWW
